R 800 600
NO ./Textures/xpm/wallN.xpm
SO ./Textures/xpm/wallS.xpm
EA ./Textures/xpm/wallE.xpm
WE ./Textures/xpm/wallW.xpm
S ./Textures/xpm/sprite4.xpm
F 39,28,22
C 0,0,1

1111111111111111111111111111111111111111
1000000000000000000110000000000000000001
1020000000000000000110000000000000000201  
1000000000000000000110000001111110000001
10200000000W0000000000000001    10000201 
1000000000000000000110000001111110000001
1020000000000000000110000000000000000201
1000000000000000000110000000000000000001
1111111111111111111111111111111111111111