R 800 600
NO ./Textures/xpm/wallN.xpm
SO ./Textures/xpm/wallS.xpm
EA ./Textures/xpm/wallE.xpm
WE ./Textures/xpm/wallW.xpm
S1 ./Textures/xpm/sprite1.xpm
S2 ./Textures/xpm/sprite2.xpm
S3 ./Textures/xpm/sprite3.xpm
S4 ./Textures/xpm/sprite4.xpm
F ./Textures/xpm/floor.xpm
C ./Textures/xpm/ceiling.xpm

111111111111111111111111111
14000000051E000000040000031
101111011110111111111110111
101531012000000300210000031
101000010050000050015400001
101111110000111000010030041
100000000004111000411111111
111111110050000050000000001
120030212000043000211111101
105405011111111111111000151
130000400000000400000010001
111111111111111111111111111