R 800 600
NO ./Textures/xpm/wallN.xpm
SO ./Textures/xpm/wallS.xpm
EA ./Textures/xpm/wallE.xpm
WE ./Textures/xpm/wallW.xpm
S1 ./Textures/xpm/sprite1.xpm
S2 ./Textures/xpm/sprite2.xpm
S3 ./Textures/xpm/sprite3.xpm
S4 ./Textures/xpm/sprite4.xpm
F ./Textures/xpm/floor.xpm
C ./Textures/xpm/ceiling.xpm

1111111111111111111111111111111111111
1000010001500514000000000000000000001
1001014101040010012050213001111111001
1041000100000310011111110401205021001
1001111111111110000040000000000040001
1000004000000000111111111111111111101
1E00400011111111131010101015101210101
1000004310400000000000040000000000001
1011111111111111110101012101013101511
1040000100040100110101011111111111111
1000500101110100000131014000000300001
1000000101500100111111000050400005001
1000340001110000000000013000000400031
1111111111111111111111111111111111111